111111111111
10000P0E1011
1C1C10001111
11111111111